11111111111111111111111111111111111111111111111111
10000000000000000000000000000000000000000000000001
10000000000000000000000000000000000000000000000001
10000000000000000000000010000000000000000000000001
10000000000000000000000010000000000000000000000001
10000000000000000000000010000000000000000000000001
10000000000000000000000010000000000000000000000001
10000001111111111111111111111111000000000000000001
10000000000000000000000000000000000000000000000001
10000000000000000000000000000000000000000000000001
10000000000000000000000000000000011111111111100001
11111110000011111111000000000000010000000000000001
10000000000000000001000000000000010000000000000001
10000000000000000001000000000000010000000000000001
10000000111111111111000000000000011111111111111111
10000000000000000000000000000000000000000000000001
10000000000000000000000000000000000000000000000001
11111111111111111111111111111111111111111111111111